34	18
5	5	5	5	5	5	5	5	5	5	5	5	5	5	5	5	5	5	5	5	5	5	5	5	5	5	5	5	5	5	5	5	5	5
5	5	5	5	5	5	5	70	81	82	82	82	82	82	82	82	82	82	82	82	82	82	82	82	83	71	5	5	5	5	5	5	5	5
5	5	5	5	5	5	5	66	84	85	85	85	85	85	85	85	85	85	85	85	85	85	85	85	86	63	5	5	5	5	5	5	5	5
5	5	5	5	5	5	5	66	87	88	88	88	88	88	88	88	88	88	88	88	88	88	88	88	89	63	5	5	5	5	5	5	5	5
5	5	5	5	5	5	5	66	11	11	11	11	11	11	11	11	11	11	11	11	11	11	11	11	11	63	5	5	5	5	5	5	5	5
5	5	5	5	5	5	5	66	11	11	11	11	11	11	11	11	11	11	11	11	11	11	11	11	11	63	5	5	5	5	5	5	5	5
5	5	5	5	5	5	5	66	11	11	11	11	11	11	11	11	11	11	11	11	11	11	11	11	11	63	5	5	5	5	5	5	5	5
5	5	5	5	5	5	5	66	11	11	11	11	11	11	11	11	11	11	11	11	11	11	11	11	11	63	5	5	5	5	5	5	5	5
5	5	5	5	5	5	5	66	11	11	11	11	11	11	11	11	11	11	11	11	11	11	11	11	11	63	5	5	5	5	5	5	5	5
5	5	5	5	5	5	5	66	11	11	11	11	11	11	11	11	11	11	11	11	11	11	11	11	11	63	5	5	5	5	5	5	5	5
5	5	5	5	5	5	5	66	11	11	11	11	11	11	11	11	11	11	11	11	11	11	11	11	11	63	5	5	5	5	5	5	5	5
5	5	5	5	5	5	5	62	69	69	69	69	69	69	69	69	69	69	69	69	69	69	69	69	69	61	5	5	5	5	5	5	5	5
5	5	5	5	5	5	5	5	5	5	5	5	5	5	5	5	5	5	5	5	5	5	5	5	5	5	5	5	5	5	5	5	5	5
5	5	5	5	5	5	5	5	5	5	5	5	5	5	5	5	5	5	5	5	5	5	5	5	5	5	5	5	5	5	5	5	5	5
5	5	5	5	5	5	5	5	5	5	5	5	5	5	5	5	5	5	5	5	5	5	5	5	5	5	5	5	5	5	5	5	5	5
5	5	5	5	5	5	5	5	5	5	5	5	5	5	5	5	5	5	5	5	5	5	5	5	5	5	5	5	5	5	5	5	5	5
5	5	5	5	5	5	5	5	5	5	5	5	5	5	5	5	5	5	5	5	5	5	5	5	5	5	5	5	5	5	5	5	5	5
5	5	5	5	5	5	5	5	5	5	5	5	5	5	5	5	5	5	5	5	5	5	5	5	5	5	5	5	5	5	5	5	5	5